.####...#..#####..###...
#####..###.#.#...#.#..##
.#.#...##...###...##.##.
#.#.##.#.##.#.#######.##
..##.####..####.##.####.
...#.#.....##.####..#..#
#.##.#....#..#.#..#.#.##
.###.##....#.......#.###
#.####.###....#..#.#..#.
##...#....#....#####...#
..#.##...#..###.#..#####
....#.#######.#....#....
..##.##......###.#..##.#
#...#...###..###.##....#
.#.##...#.#.##.##...###.
#.###.#....####....#..##
#.###...#.##...#.######.
.###.###.#######..#####.
..##.#..#..#.#######.###
#.#..##.########..#..##.
#.#####..#.#...##..#....
#....##..#.#########..##
#...#.....#..##...###.##
#..###....##.#...##.##.#
